xxxxxxxxxxxxxxx
d...xx...xx.xxx
xxx.xxx.x.....x
x.x.......x.xxx
x...xxx.x.x...x
x.xxx...x.x.x.x
x.x.x.x.x.x.x.x
x.x.x.x.x.....x
x........xx.xxx
x.xx.x.x......x
x.x..x.xxxxx.xx
x.xx.x........x
x....x.xxx.xxxx
xxxx.x...x....a
xxxxxxxxxxxxxxx